28 28 28 28 30 30 28 28 28 28
28 00 00 00 00 00 00 00 00 28
28 00 00 00 00 00 00 00 00 28
28 00 00 00 00 00 00 00 00 28
31 00 00 00 00 00 00 00 00 31
31 00 00 00 00 00 00 00 00 31
28 00 00 00 00 00 00 00 00 28
28 00 00 00 00 00 00 00 00 28
28 00 00 00 00 00 00 00 00 28
28 28 28 28 30 30 28 28 28 28